1 1 1 1 1 1 1 1 1 1 1 1 1 1 1 1 1 1 1 1 1 1 1 1 1 1 1 1 1 1 1 1 1 1 1 1 1 1 1 1 1 1 1 1 1 1 1 1 1 1 1 1 1 1 1 1 1 1 1 1 1 1 1 1 1 1 1 1 1 1 1 1 1 1 1 1 1 1 1 1 1 1 1 1 1 1 1 1 1 1 1 1 1 1 1 1 1 1 1 1
1 1 1 1 1 1 1 1 1 1 1 1 1 1 1 1 1 1 1 1 1 1 1 1 1 1 1 1 1 1 1 1 1 1 1 1 1 1 1 1 1 1 1 1 1 1 1 1 1 1 1 1 1 1 1 1 1 1 1 1 1 1 1 1 1 1 1 1 1 1 1 1 1 1 1 1 1 1 1 1 1 1 1 1 1 1 1 1 1 1 1 1 1 1 1 1 1 1 1 1
1 1 1 1 1 1 1 1 1 1 1 1 1 1 1 1 1 1 1 1 1 1 1 1 1 1 1 1 1 1 1 1 1 1 1 1 1 1 1 1 1 1 1 1 1 1 1 1 1 1 1 1 1 1 1 1 1 1 1 1 1 1 1 1 1 1 1 1 1 1 1 1 1 1 1 1 1 1 1 1 1 1 1 1 1 1 1 1 1 1 1 1 1 1 1 1 1 1 1 1
1 1 1 1 1 1 1 1 1 1 1 1 1 1 1 1 1 1 1 1 1 1 1 1 1 1 1 1 1 1 1 1 1 1 1 1 1 1 1 1 1 1 1 1 1 1 1 1 1 1 1 1 1 1 1 1 1 1 1 1 1 1 1 1 1 1 1 1 1 1 1 1 1 1 1 1 1 1 1 1 1 1 1 1 1 1 1 1 1 1 1 1 1 1 1 1 1 1 1 1
1 1 1 1 1 1 1 1 1 1 1 1 1 1 1 1 1 1 1 1 1 1 1 1 1 1 1 1 1 1 1 1 1 1 1 1 1 1 1 1 1 1 1 1 1 1 1 1 1 1 1 1 1 1 1 1 1 1 1 1 1 1 1 1 1 1 1 1 1 1 1 1 1 1 1 1 1 1 1 1 1 1 1 1 1 1 1 1 1 1 1 1 1 1 1 1 1 1 1 1
1 1 1 1 1 1 1 1 1 1 1 1 1 1 1 1 1 1 1 1 1 1 1 1 1 1 1 1 1 1 1 1 1 1 1 1 1 1 1 1 1 1 1 1 1 1 1 1 1 1 1 1 1 1 1 1 1 1 1 1 1 1 1 1 1 1 1 1 1 1 1 1 1 1 1 1 1 1 1 1 1 1 1 1 1 1 1 1 1 1 1 1 1 1 1 1 1 1 1 1
1 1 1 1 1 1 1 1 1 1 1 1 1 1 1 1 1 1 1 1 1 1 1 1 1 1 1 1 1 1 1 1 1 1 1 1 1 1 1 1 1 1 1 1 1 1 1 1 1 1 1 1 1 1 1 1 1 1 1 1 1 1 1 1 1 1 1 1 1 1 1 1 1 1 1 1 1 1 1 1 1 1 1 1 1 1 1 1 1 1 1 1 1 1 1 1 1 1 1 1
1 1 1 1 1 1 1 1 1 1 1 1 55 55 55 55 0 0 0 0 0 0 0 0 0 0 306 55 55 55 55 55 1 1 1 1 1 1 1 1 1 1 301 0 0 0 0 0 306 0 0 0 0 0 0 0 55 55 0 0 0 0 55 55 0 0 0 0 55 55 0 0 0 0 0 0 0 0 306 0 0 0 0 0 0 0 0 0 1 1 1 1 1 1 1 1 1 1 1 1
1 1 1 1 1 1 1 1 1 1 1 0 0 0 0 0 0 0 0 0 101 101 101 0 0 0 305 0 0 0 0 0 0 0 1 1 1 1 1 1 55 55 302 0 0 0 0 0 305 0 0 0 0 0 0 0 0 0 0 0 0 0 0 0 0 0 0 0 0 0 0 0 0 0 0 0 0 0 305 0 0 0 0 0 0 0 0 0 0 1 1 1 1 1 1 1 1 1 1 1
1 1 1 1 1 1 1 1 1 1 0 0 0 0 0 0 0 0 0 101 0 0 0 101 0 0 305 0 0 0 0 0 0 0 0 1 1 1 1 55 0 0 302 0 0 0 0 0 305 0 101 101 0 0 0 0 101 101 0 0 0 0 101 101 0 0 0 0 101 101 0 0 0 0 0 101 101 0 305 0 0 0 0 0 0 0 0 0 0 0 1 1 1 1 1 1 1 1 1 1
1 1 1 1 1 1 1 1 1 1 6 0 0 0 0 0 0 0 0 0 0 0 0 0 0 0 305 0 0 0 0 0 0 0 0 1 1 1 1 0 0 0 303 0 0 0 0 0 305 1 1 1 1 51 51 1 1 1 1 51 51 1 1 1 1 51 51 1 1 1 1 51 51 1 1 1 1 1 305 0 0 0 0 0 0 0 0 0 0 0 1 1 1 1 1 1 1 1 1 1
1 1 1 1 1 1 1 1 1 1 5 0 0 0 0 0 0 0 0 0 0 0 0 0 0 0 0 0 0 0 0 0 0 0 0 0 1 1 53 0 0 0 304 0 0 0 0 0 1 1 1 1 1 1 1 1 1 1 1 1 1 1 1 1 1 1 1 1 1 1 1 1 1 1 1 1 1 1 1 0 0 0 0 0 0 0 0 0 0 0 1 1 1 1 1 1 1 1 1 1
1 1 1 1 1 1 1 1 1 1 1 5 0 0 0 0 0 0 0 0 0 0 0 0 0 0 0 0 0 0 0 0 0 0 0 0 1 1 53 0 0 0 302 0 0 0 0 1 1 305 0 0 301 0 0 0 0 0 301 0 0 0 0 0 1 5 5 6 1 0 0 0 306 0 0 0 1 1 1 1 52 52 0 101 101 101 0 0 0 0 1 1 1 1 1 1 1 1 1 1
1 1 1 1 1 1 1 1 1 1 1 1 0 0 0 0 0 0 0 0 52 52 52 0 304 0 0 0 0 0 0 0 0 0 0 0 1 1 53 0 0 0 302 0 0 0 1 1 305 305 0 0 302 0 0 0 0 0 302 0 0 0 0 0 0 1 1 1 0 0 0 0 305 0 0 0 0 1 1 1 1 1 1 1 1 1 0 0 0 0 1 1 1 1 1 1 1 1 1 1
1 1 1 1 1 1 1 1 1 1 1 1 1 1 1 1 1 1 1 1 1 1 1 1 1 1 1 0 0 0 0 0 0 0 0 0 1 1 53 0 0 0 302 0 0 0 1 1 6 305 0 0 302 0 0 0 0 0 303 0 0 0 0 0 0 0 0 0 0 0 0 0 305 0 0 0 0 0 1 1 1 1 1 1 1 1 0 0 0 0 1 1 1 1 1 1 1 1 1 1
1 1 1 1 1 1 1 1 1 1 1 1 1 1 1 1 1 1 1 1 1 1 1 1 1 55 55 0 0 0 0 0 0 0 0 54 1 1 53 0 0 0 302 0 101 101 1 1 5 5 101 0 303 0 0 0 0 0 0 0 0 0 0 0 0 0 0 0 0 0 0 0 305 0 0 0 0 0 1 1 1 1 55 55 55 55 0 0 0 0 1 1 1 1 1 1 1 1 1 1
1 1 1 1 1 1 1 1 1 1 1 1 1 1 1 1 1 1 1 1 1 1 1 301 305 0 0 0 0 0 0 0 0 0 0 54 1 1 53 0 0 0 302 0 3 3 1 1 5 5 101 101 0 0 201 0 0 0 0 0 0 0 0 0 0 0 0 0 0 0 0 0 0 0 0 0 0 0 1 1 1 0 0 0 0 0 0 0 0 1 1 1 1 1 1 1 1 1 1 1
1 1 1 1 1 1 1 1 1 1 1 1 1 1 0 0 0 0 0 301 0 0 0 302 0 0 0 0 0 0 0 0 0 0 0 54 1 1 53 0 0 0 302 0 0 0 0 1 1 5 5 101 304 0 0 0 0 0 0 0 52 52 52 52 0 0 101 101 101 101 101 0 0 0 0 0 0 101 1 1 0 0 0 0 101 101 101 0 1 1 1 1 1 1 1 1 1 1 1 1
1 1 1 1 1 1 1 1 1 1 1 1 306 0 0 0 0 0 0 302 0 0 0 302 0 0 0 0 0 0 0 0 0 0 54 1 1 1 1 0 0 0 302 0 0 0 0 0 1 1 1 1 1 1 1 1 1 1 1 1 1 1 1 1 1 1 1 1 1 1 1 1 1 0 0 0 0 4 1 1 0 0 0 0 1 1 1 1 1 1 1 1 1 1 1 1 1 1 1 1
1 1 1 1 1 1 1 1 1 1 1 0 305 0 0 0 0 0 0 302 0 0 0 302 0 0 0 0 0 0 0 0 0 0 54 1 1 1 1 52 0 0 302 0 0 0 0 0 0 0 1 1 1 1 1 1 1 1 1 1 1 1 1 1 1 1 1 1 1 1 1 1 1 0 0 0 0 0 1 1 0 0 0 0 1 1 1 1 1 1 1 1 1 1 1 1 1 1 1 1
1 1 1 1 1 1 1 1 1 1 1 0 305 0 0 0 0 0 0 302 0 0 0 302 0 0 0 0 0 0 0 0 0 6 1 1 1 1 1 1 52 52 302 0 0 0 0 0 0 0 0 0 0 0 0 0 0 0 0 0 0 0 0 0 0 0 0 0 0 0 1 1 1 101 0 0 0 0 1 1 0 0 0 0 55 55 55 55 1 1 1 1 1 1 1 1 1 1 1 1
1 1 1 1 1 1 1 1 1 1 0 0 305 0 0 0 0 0 0 302 0 0 0 303 0 101 101 101 101 101 0 0 1 1 1 1 1 1 1 1 1 1 302 0 101 101 101 101 0 0 0 0 0 0 0 0 0 0 0 0 0 0 0 0 0 0 0 0 0 0 0 1 1 2 0 0 0 0 1 1 5 0 0 0 0 0 0 0 301 1 1 1 1 1 1 1 1 1 1 1
1 1 1 1 1 1 1 1 1 1 0 0 0 0 0 0 0 0 0 302 0 0 0 304 0 1 1 1 1 1 1 1 1 1 1 1 1 1 1 1 1 1 1 1 1 1 1 1 1 1 0 0 0 0 0 0 0 0 0 0 0 0 0 0 0 0 0 0 0 0 152 1 1 0 0 0 0 0 1 1 1 6 0 0 0 0 0 0 302 0 1 1 1 1 1 1 1 1 1 1
1 1 1 1 1 1 1 1 1 1 101 0 0 0 0 0 0 0 0 302 0 5 5 1 1 1 1 1 1 1 1 1 1 1 1 1 1 1 1 1 1 1 1 1 1 1 1 1 1 1 1 1 0 0 101 101 101 101 101 0 0 0 0 0 0 0 101 101 101 0 1 1 1 0 0 0 0 0 1 1 1 1 0 101 101 101 0 0 302 0 1 1 1 1 1 1 1 1 1 1
1 1 1 1 1 1 1 1 1 1 101 0 0 0 0 0 0 0 1 1 1 1 1 1 1 1 1 1 1 1 1 1 1 1 1 1 1 1 1 1 1 1 1 1 1 1 1 1 1 1 1 1 1 1 1 1 1 1 1 1 1 1 51 51 51 1 1 1 1 1 1 1 1 0 0 0 0 101 1 1 1 1 1 1 1 1 0 0 302 0 1 1 1 1 1 1 1 1 1 1
1 1 1 1 1 1 1 1 1 1 101 0 0 0 0 0 0 0 1 1 1 1 1 1 1 1 1 1 1 1 1 1 1 1 1 1 1 1 1 1 1 1 1 1 1 1 1 1 1 1 1 1 1 1 1 1 1 1 1 1 1 1 1 1 1 1 1 1 1 1 1 1 1 0 0 0 0 4 1 1 1 1 1 1 1 1 0 0 303 0 1 1 1 1 1 1 1 1 1 1
1 1 1 1 1 1 1 1 1 1 101 0 0 0 0 0 0 0 55 55 0 0 0 0 0 0 0 0 301 0 0 0 0 0 0 0 0 0 0 0 0 0 0 0 0 0 55 55 55 1 1 1 1 55 55 55 55 55 0 0 0 0 0 0 306 0 0 306 0 0 0 0 0 0 0 0 0 0 0 0 301 0 0 0 0 0 0 0 0 0 1 1 1 1 1 1 1 1 1 1
1 1 1 1 1 1 1 1 1 1 0 0 0 0 0 0 0 0 0 0 0 0 0 0 0 0 0 0 302 0 0 0 0 0 0 0 0 0 0 0 0 0 0 0 0 0 0 0 0 0 1 1 306 0 0 0 0 0 0 0 0 0 0 0 305 0 0 305 0 0 0 0 0 0 0 0 0 0 0 0 302 0 0 0 0 0 0 0 0 0 1 1 1 1 1 1 1 1 1 1
1 1 1 1 1 1 1 1 1 1 1 53 0 0 0 0 0 0 0 0 0 0 0 0 0 0 0 0 303 0 0 0 0 0 101 101 101 101 101 101 101 101 0 0 0 0 0 0 0 0 301 301 305 0 0 0 0 0 0 0 0 0 0 0 305 0 0 305 0 0 0 0 0 0 0 0 0 0 0 0 302 0 0 0 0 0 0 0 0 0 1 1 1 1 1 1 1 1 1 1
1 1 1 1 1 1 1 1 1 1 1 53 0 0 0 0 0 0 0 0 0 0 0 0 0 0 0 0 304 0 0 0 0 101 0 0 0 0 0 0 0 0 101 0 0 0 0 0 0 0 303 0 305 0 0 0 0 0 0 0 0 0 0 0 3 3 3 3 0 0 0 0 0 0 0 0 0 0 0 0 303 0 0 0 0 0 0 0 304 101 1 1 1 1 1 1 1 1 1 1
1 1 1 1 1 1 1 1 1 1 1 1 0 0 0 0 0 0 0 0 0 0 0 0 0 0 0 0 302 0 0 0 0 0 0 0 0 0 0 0 0 0 0 0 0 0 0 0 0 0 0 304 0 0 0 0 0 0 0 0 5 0 0 0 0 0 0 0 0 0 0 0 0 0 0 0 0 0 0 0 0 0 0 0 0 0 0 0 302 1 1 1 1 1 1 1 1 1 1 1
1 1 1 1 1 1 1 1 1 1 1 1 1 1 53 0 101 101 101 101 101 0 0 0 0 0 0 0 302 0 52 52 0 0 0 0 0 0 0 0 0 0 0 0 0 0 0 0 0 0 304 302 0 0 0 0 0 0 0 5 6 0 0 0 0 0 0 0 0 0 52 52 52 5 5 0 0 0 0 0 304 0 101 101 101 101 101 0 1 1 1 1 1 1 1 1 1 1 1 1
1 1 1 1 1 1 1 1 1 1 1 1 1 1 1 1 1 1 1 1 1 51 51 51 1 1 1 1 1 1 1 1 2 3 3 3 3 3 3 3 3 3 4 1 1 1 0 0 0 0 1 1 0 0 0 0 1 1 1 1 1 1 1 1 51 51 51 51 1 1 1 1 1 1 1 1 51 51 51 51 1 1 1 1 1 1 1 1 1 1 1 1 1 1 1 1 1 1 1 1
1 1 1 1 1 1 1 1 1 1 1 1 1 1 1 1 1 1 1 1 1 1 1 1 1 1 1 1 1 1 1 1 51 51 51 51 51 51 51 51 51 51 51 1 1 1 101 0 0 0 1 1 0 0 0 0 1 1 1 1 1 1 1 1 1 1 1 1 1 1 1 1 1 1 1 1 1 1 1 1 1 1 1 1 1 1 1 1 1 1 1 1 1 1 1 1 1 1 1 1
1 1 1 1 1 1 1 1 1 1 1 1 0 0 0 0 0 306 0 0 0 0 306 101 101 101 101 101 101 54 1 1 51 51 51 51 51 51 51 51 51 51 51 1 1 2 3 0 0 0 1 1 101 0 0 0 1 1 1 1 53 0 0 0 306 0 55 55 55 0 0 0 0 0 0 0 0 55 55 55 0 0 0 306 0 0 0 54 1 1 1 1 1 1 1 1 1 1 1 1
1 1 1 1 1 1 1 1 1 1 1 306 0 0 0 0 0 305 0 0 0 0 305 101 101 101 101 101 101 54 1 1 1 1 1 1 1 1 1 1 1 1 1 1 1 0 0 0 0 0 1 1 2 0 0 0 1 1 1 53 0 0 0 0 305 0 0 0 0 0 0 0 0 0 0 0 0 0 0 0 0 0 0 305 0 0 0 0 54 1 1 1 1 1 1 1 1 1 1 1
1 1 1 1 1 1 1 1 1 1 0 305 0 0 0 0 0 0 0 0 0 0 3 3 3 3 3 3 3 3 4 1 1 1 1 1 1 1 1 1 1 1 1 1 0 0 0 0 0 101 1 1 0 0 0 0 1 1 53 0 0 0 0 0 305 0 0 0 0 0 0 0 0 0 0 0 0 0 0 0 0 0 0 305 0 0 0 0 0 54 1 1 1 1 1 1 1 1 1 1
1 1 1 1 1 1 1 1 1 1 0 305 0 0 0 0 0 0 0 0 0 0 0 0 0 0 0 0 0 0 0 0 0 0 0 0 55 55 55 0 306 0 0 0 0 0 0 0 0 101 1 1 0 0 0 0 1 1 0 0 0 0 0 0 0 101 101 101 101 0 0 0 0 0 0 0 0 0 101 101 101 101 0 305 0 0 0 0 0 0 1 1 1 1 1 1 1 1 1 1
1 1 1 1 1 1 1 1 1 1 0 305 0 0 0 0 0 0 0 0 0 0 0 0 0 0 0 0 0 0 0 0 0 0 0 0 0 0 0 0 305 0 0 0 0 0 0 0 0 101 1 1 0 0 304 0 1 1 0 0 0 0 0 0 0 1 1 1 1 1 1 51 51 51 51 1 1 1 1 1 1 1 0 305 0 0 0 101 101 101 1 1 1 1 1 1 1 1 1 1
1 1 1 1 1 1 1 1 1 1 0 305 0 0 0 0 0 0 0 0 0 0 0 0 0 0 0 0 0 0 0 0 0 0 0 0 0 0 0 0 305 0 0 0 0 0 0 0 0 101 1 1 0 0 302 101 1 1 0 0 0 0 0 0 1 1 1 1 1 1 1 1 1 1 1 1 1 1 1 1 1 1 1 0 0 0 0 3 3 4 1 1 1 1 1 1 1 1 1 1
1 1 1 1 1 1 1 1 1 1 0 305 0 0 0 1 0 0 0 0 0 0 0 0 0 0 0 0 0 0 304 0 0 0 0 0 0 0 0 0 0 0 0 0 0 0 0 0 0 1 1 1 0 0 302 4 1 1 0 0 0 0 0 1 1 1 301 0 55 55 55 55 306 55 55 55 55 305 55 0 301 1 1 1 0 0 0 0 0 0 1 1 1 1 1 1 1 1 1 1
1 1 1 1 1 1 1 1 1 1 0 305 0 0 0 1 1 52 52 52 0 0 101 101 101 101 0 0 0 0 302 52 52 52 0 0 101 101 101 101 0 52 52 52 0 0 0 0 1 1 1 1 0 0 302 0 1 1 0 0 0 0 0 1 1 306 302 0 0 0 0 0 305 0 0 0 0 305 0 0 302 305 1 1 0 0 0 0 0 0 1 1 1 1 1 1 1 1 1 1
1 1 1 1 1 1 1 1 1 1 0 305 0 0 0 1 1 1 1 1 1 1 1 1 1 1 1 1 1 1 1 1 1 1 1 1 1 1 1 1 1 1 1 1 1 1 1 1 1 1 1 1 0 0 302 0 1 1 101 0 0 0 0 1 1 305 302 0 0 0 0 0 305 0 0 0 0 0 0 0 302 305 1 1 0 0 0 0 0 0 1 1 1 1 1 1 1 1 1 1
1 1 1 1 1 1 1 1 1 1 0 0 0 0 0 1 1 1 1 1 1 1 1 1 1 1 1 1 1 1 1 1 1 1 1 1 1 1 1 1 1 1 1 1 1 1 1 1 1 1 1 1 52 0 302 52 1 1 6 101 0 0 0 1 1 305 302 0 0 0 0 0 305 0 0 0 0 0 0 0 302 0 1 1 101 101 101 0 0 0 1 1 1 1 1 1 1 1 1 1
1 1 1 1 1 1 1 1 1 1 0 0 0 0 0 1 1 0 0 301 0 0 0 55 55 55 0 55 55 0 55 0 55 55 0 0 0 0 0 0 0 101 101 0 0 0 0 0 0 0 1 1 1 153 302 1 1 1 2 3 0 0 0 1 1 0 302 0 0 0 0 0 0 0 0 304 0 0 0 0 302 0 1 1 2 3 3 0 0 0 1 1 1 1 1 1 1 1 1 1
1 1 1 1 1 1 1 1 1 1 101 0 0 0 0 1 0 0 0 302 0 0 0 0 0 0 0 0 0 0 0 0 0 0 0 0 0 0 0 0 101 0 0 101 0 0 0 0 0 0 0 1 1 1 1 1 1 0 0 0 0 0 0 1 1 101 302 0 0 0 0 0 0 0 0 302 0 0 0 0 302 101 1 1 0 0 0 0 0 0 1 1 1 1 1 1 1 1 1 1
1 1 1 1 1 1 1 1 1 1 101 0 0 0 0 0 0 0 0 302 0 0 0 0 0 0 0 0 0 0 0 0 0 0 0 0 0 0 0 0 0 0 0 0 0 0 0 0 0 0 0 301 1 1 1 1 0 0 0 0 0 0 0 1 1 101 302 0 0 0 0 1 1 1 1 1 1 0 0 0 302 101 1 1 0 0 0 0 0 0 1 1 1 1 1 1 1 1 1 1
1 1 1 1 1 1 1 1 1 1 101 0 0 0 0 0 0 0 0 302 0 0 0 0 0 0 0 0 0 0 0 0 0 0 0 0 0 0 0 0 0 0 0 0 0 0 0 0 0 0 0 302 0 0 0 0 0 0 0 0 0 0 0 1 1 101 302 0 0 0 1 1 101 101 101 101 1 1 0 0 302 101 1 1 0 0 0 0 0 0 1 1 1 1 1 1 1 1 1 1
1 1 1 1 1 1 1 1 1 1 0 0 0 0 0 0 0 0 0 302 0 0 0 0 0 0 0 0 0 0 0 0 0 0 0 0 0 0 0 0 0 0 0 0 0 0 0 0 0 0 0 302 0 0 0 0 0 0 0 0 0 0 0 1 1 101 302 0 0 1 1 101 101 101 101 101 101 1 1 0 302 101 1 1 0 0 0 101 101 101 1 1 1 1 1 1 1 1 1 1
1 1 1 1 1 1 1 251 251 251 0 0 0 0 0 0 0 0 0 302 0 0 0 0 0 0 0 0 0 0 0 0 0 0 0 0 0 0 0 0 0 52 52 0 0 0 0 0 0 0 0 302 0 0 0 0 0 0 0 0 0 0 101 1 1 0 302 0 0 1 101 101 101 101 101 101 101 101 1 0 302 0 1 1 0 0 0 3 3 4 1 1 1 1 1 1 1 1 1 1
1 1 1 1 1 1 1 251 1 1 0 0 0 0 0 0 0 0 0 303 0 0 0 0 0 6 0 0 0 0 0 0 0 0 0 101 101 0 52 1 1 1 1 1 1 52 0 101 101 0 0 303 0 0 0 0 0 0 0 0 0 0 5 1 1 0 302 0 0 1 101 101 101 101 101 101 101 101 1 0 302 0 0 0 0 0 0 0 0 0 1 1 1 1 1 1 1 1 1 1
1 1 1 1 1 1 1 251 1 1 1 0 0 0 0 0 0 0 0 304 0 101 5 6 101 5 5 101 0 0 0 0 0 0 52 1 1 1 1 1 101 101 101 101 1 1 1 1 1 52 0 304 0 0 0 0 0 0 0 0 0 0 1 1 1 0 302 0 52 1 101 101 101 101 101 101 101 101 1 0 302 0 0 0 0 0 0 0 0 0 1 1 1 1 1 1 1 1 1 1
1 1 1 1 1 1 1 251 1 1 1 1 52 52 52 52 0 0 0 302 0 5 6 5 101 5 5 101 5 0 0 52 1 1 1 1 101 101 101 101 101 101 101 101 101 101 101 101 1 1 1 1 52 0 0 101 101 0 6 6 0 1 1 1 1 1 251 251 1 1 101 101 101 101 101 101 101 151 1 1 302 0 0 0 0 0 0 0 0 0 1 1 1 1 1 1 1 1 1 1
1 1 1 1 1 1 1 251 1 1 1 1 1 1 1 1 1 1 1 1 1 1 1 1 1 1 1 1 1 1 1 1 1 1 1 1 251 251 1 1 1 1 1 1 1 1 1 1 1 1 1 1 1 1 1 1 1 1 1 1 1 1 1 1 1 1 251 251 1 1 1 1 1 251 251 1 1 1 1 1 1 1 1 1 1 51 51 51 51 1 1 1 1 1 1 1 1 1 1 1
1 1 1 1 1 1 1 251 251 251 251 251 251 251 251 251 251 251 251 251 251 251 251 251 251 251 251 251 251 251 251 251 251 251 251 251 251 1 1 1 1 1 1 1 1 1 1 1 1 1 1 1 1 1 1 1 1 1 1 1 1 1 1 1 1 1 251 251 1 1 1 1 1 251 251 1 1 1 1 1 1 1 1 1 1 1 1 1 1 1 1 1 1 1 1 1 1 1 1 1
1 1 1 1 1 1 1 1 1 1 1 1 1 1 1 1 1 1 1 1 1 1 1 1 1 1 1 1 1 1 1 1 1 1 1 1 1 1 1 1 1 1 1 1 1 1 1 1 1 1 1 1 1 1 1 1 1 1 1 1 1 1 1 1 1 1 251 251 251 251 251 251 251 251 251 1 1 1 1 1 1 1 1 1 1 1 1 1 1 1 1 1 1 1 1 1 1 1 1 1
1 1 1 1 1 1 1 1 1 1 1 1 1 1 1 1 1 1 1 1 1 1 1 1 1 1 1 1 1 1 1 1 1 1 1 1 1 1 1 1 1 1 1 1 1 1 1 1 1 1 1 1 1 1 1 1 1 1 1 1 1 1 1 1 1 1 1 1 1 1 1 1 1 1 1 1 1 1 1 1 1 1 1 1 1 1 1 1 1 1 1 1 1 1 1 1 1 1 1 1
1 1 1 1 1 1 1 1 1 1 1 1 1 1 1 1 1 1 1 1 1 1 1 1 1 1 1 1 1 1 1 1 1 1 1 1 1 1 1 1 1 1 1 1 1 1 1 1 1 1 1 1 1 1 1 1 1 1 1 1 1 1 1 1 1 1 1 1 1 1 1 1 1 1 1 1 1 1 1 1 1 1 1 1 1 1 1 1 1 1 1 1 1 1 1 1 1 1 1 1
1 1 1 1 1 1 1 1 1 1 1 1 1 1 1 1 1 1 1 1 1 1 1 1 1 1 1 1 1 1 1 1 1 1 1 1 1 1 1 1 1 1 1 1 1 1 1 1 1 1 1 1 1 1 1 1 1 1 1 1 1 1 1 1 1 1 1 1 1 1 1 1 1 1 1 1 1 1 1 1 1 1 1 1 1 1 1 1 1 1 1 1 1 1 1 1 1 1 1 1
1 1 1 1 1 1 1 1 1 1 1 1 1 1 1 1 1 1 1 1 1 1 1 1 1 1 1 1 1 1 1 1 1 1 1 1 1 1 1 1 1 1 1 1 1 1 1 1 1 1 1 1 1 1 1 1 1 1 1 1 1 1 1 1 1 1 1 1 1 1 1 1 1 1 1 1 1 1 1 1 1 1 1 1 1 1 1 1 1 1 1 1 1 1 1 1 1 1 1 1
